[filename]
arrow

[lap-record]
00:07:83

[start-line]
down
11 9
11 11

[board]
1 1 1 1 1 1 6 6 6 6 6 6 6 6 6 1 1 1 1 1 1
1 1 1 1 1 6 6 1 1 1 1 1 1 1 6 6 1 1 1 1 1
1 1 1 1 6 6 1 1 1 1 1 1 1 1 1 6 6 1 1 1 1
1 1 1 6 6 1 1 1 1 1 1 1 1 1 1 1 6 6 1 1 1
1 1 6 6 1 1 1 1 1 1 1 1 1 1 1 1 1 6 6 1 1
1 6 6 1 1 1 1 1 1 1 1 1 1 1 1 1 1 1 6 6 1
6 6 1 1 1 1 1 1 1 1 1 1 1 1 1 1 1 1 1 6 6
6 6 1 1 1 6 6 6 6 1 1 1 6 6 6 6 6 1 1 1 6
6 1 1 1 1 1 1 1 6 1 1 1 6 1 1 1 1 1 1 1 6
6 1 1 1 1 1 1 1 6 1 1 1 6 1 1 1 1 1 1 1 6
6 1 1 1 1 1 7 7 7 1 1 1 7 7 7 1 1 1 1 1 6
6 1 1 1 1 1 7 7 7 0 0 0 7 7 7 1 1 1 1 1 6
6 1 1 1 1 1 7 1 1 1 1 1 1 1 7 1 1 1 1 1 6
6 1 1 1 1 7 1 1 7 1 1 1 7 1 1 7 1 1 1 1 6
6 1 1 1 1 7 1 7 1 1 1 1 1 7 1 7 1 1 1 1 6
6 1 1 1 7 1 1 1 7 1 1 1 7 1 1 1 7 1 1 1 6
6 1 1 1 1 1 1 7 7 1 1 1 7 7 1 1 1 1 1 1 6
6 1 1 1 1 1 7 1 7 1 1 1 7 1 7 1 1 1 1 1 6
6 1 1 1 1 1 1 1 7 1 1 1 7 1 1 1 1 1 1 1 6
6 1 1 1 1 1 1 1 7 1 1 1 7 1 1 1 1 1 1 1 6
6 1 1 1 1 7 1 1 7 1 1 1 7 1 1 7 1 1 1 1 6
6 1 1 1 1 1 1 1 1 1 1 1 1 1 1 1 1 1 1 1 6
6 1 1 7 1 1 1 1 1 1 1 1 1 1 1 1 1 7 1 1 6
6 1 1 1 1 1 1 1 1 1 1 1 1 1 1 1 1 1 1 1 6
6 7 1 1 1 1 1 1 1 1 1 1 1 1 1 1 1 1 1 7 6
6 6 6 6 6 6 6 6 6 6 6 6 6 6 6 6 6 6 6 6 6

[time-record]
00:32:55

[description]
starting on the top

[start-position]
11 8
left

[laps]
2

[size]
21 26

