[laps]
1

[size]
20 20

[board]
1 1 2 2 2 2 2 2 2 2 2 2 2 2 2 2 2 1 1 1
1 2 2 1 1 1 1 1 1 1 1 1 1 1 1 1 2 2 1 1
2 2 1 1 1 1 1 1 1 1 1 1 1 1 1 1 1 2 2 1
2 1 1 1 1 1 1 1 1 1 1 1 1 1 1 1 1 1 2 2
2 1 1 1 2 2 2 2 2 2 2 2 2 2 2 1 1 1 1 2
2 0 0 0 2 1 1 1 1 1 1 1 1 1 2 2 1 1 1 2
2 1 1 1 2 1 1 1 1 1 1 3 3 1 1 2 1 1 1 2
2 1 1 1 2 1 1 1 1 1 1 1 3 1 1 2 1 1 1 2
2 1 1 1 2 1 3 3 3 3 3 1 3 1 1 2 1 1 1 2
2 1 1 1 2 1 1 1 1 1 1 1 3 1 1 2 1 1 1 2
2 1 1 1 2 1 1 1 1 1 1 1 3 1 1 2 1 1 1 2
2 1 1 1 2 1 3 3 3 3 3 1 3 1 1 2 1 1 1 2
2 1 1 1 2 1 1 1 1 1 1 1 3 1 1 2 1 1 1 2
2 1 1 1 2 2 1 1 1 1 1 3 3 1 1 2 1 1 1 2
2 1 1 1 1 2 2 2 1 1 1 1 1 1 1 2 1 1 1 2
2 2 1 1 1 1 1 2 2 1 1 1 1 1 2 2 1 1 1 2
1 2 2 1 1 1 1 1 2 2 2 2 2 2 2 1 1 1 2 2
1 1 2 2 1 1 1 1 1 1 1 1 1 1 1 1 1 1 2 1
1 1 1 2 2 2 1 1 1 1 1 1 1 1 1 1 1 2 2 1
1 1 1 1 1 2 2 2 2 2 2 2 2 2 2 2 2 2 1 1

[start-position]
7 2
up

[start-line]
down
5 1
5 2
5 3

[title]
A test

