[size]
20 20

[board]
1 1 1 1 1 1 1 1 1 1 1 1 1 1 1 1 1 1 1 1
1 1 1 1 1 1 1 1 1 1 1 1 1 1 1 1 1 1 1 1
1 1 0 0 0 0 0 2 0 0 0 0 0 0 0 0 0 0 1 1
1 1 0 0 0 0 0 2 0 0 0 0 0 0 0 0 0 0 1 1
1 1 0 0 0 0 1 1 1 1 1 1 1 1 0 0 0 0 1 1
1 1 0 0 0 1 1 1 1 1 1 1 1 1 1 0 0 0 1 1
1 1 0 0 0 1 1 1 1 1 1 1 1 1 1 1 0 0 1 1
1 1 0 0 0 1 1 1 1 1 1 1 1 1 1 1 0 0 1 1
1 1 0 0 0 1 1 1 1 1 1 1 1 1 1 1 0 0 1 1
1 1 0 0 0 1 1 1 1 1 1 1 1 1 1 1 0 0 1 1
1 1 0 0 0 1 1 1 1 1 1 1 1 1 1 1 0 0 1 1
1 1 0 0 0 1 1 1 1 1 1 1 1 1 1 1 0 0 1 1
1 1 0 0 0 1 1 1 0 0 0 0 1 1 1 1 0 0 1 1
1 1 0 0 0 1 1 0 0 0 0 0 0 1 1 1 0 0 1 1
1 1 0 0 0 1 1 0 0 0 0 0 0 1 1 1 0 0 1 1
1 1 0 0 0 0 0 0 0 0 0 0 0 0 0 0 0 0 1 1
1 1 0 0 0 0 0 0 0 0 1 0 0 0 0 0 0 0 1 1
1 1 1 0 0 0 0 0 0 1 1 0 0 0 0 0 0 0 1 1
1 1 1 1 1 1 1 1 1 1 1 1 1 1 1 1 1 1 1 1
1 1 1 1 1 1 1 1 1 1 1 1 1 1 1 1 1 1 1 1

[start-line]
up
2 7
3 7

[start-position]
3 4
up