[filename]
circuit0

[lap-record]
00:07:58

[start-line]
left
1 12
4 13

[board]
4 4 4 4 4 4 4 4 4 4 4 4 4 4 4 4 4 4 4 4 4 4 4 4 4
4 4 4 4 3 3 3 3 3 3 3 3 0 0 3 3 3 3 3 3 3 4 4 4 4
4 4 4 3 3 3 3 3 3 3 3 3 0 0 3 3 3 3 3 3 3 3 4 4 4
4 4 3 3 3 3 3 3 3 3 3 3 0 0 3 3 3 3 3 3 3 3 3 4 4
4 3 3 3 3 3 3 3 3 3 3 3 0 0 3 3 3 3 3 3 3 3 3 3 4
4 3 3 3 3 4 4 4 4 4 4 4 4 4 4 4 4 4 4 4 3 3 3 3 4
4 3 3 3 3 4 4 4 2 2 2 2 2 2 2 2 2 4 4 4 3 3 3 3 4
4 3 3 3 3 4 2 4 4 4 2 2 2 2 2 4 4 4 2 4 3 3 3 3 4
4 3 3 3 3 4 2 2 2 4 4 4 2 4 4 4 2 2 2 4 3 3 3 3 4
4 3 3 3 3 4 2 2 2 2 2 2 4 2 2 2 2 2 2 4 3 3 3 3 4
4 3 3 3 3 4 2 2 2 2 2 2 4 2 2 2 2 2 2 4 3 3 3 3 4
4 3 3 3 3 4 2 2 2 4 4 4 2 4 4 4 2 2 2 4 3 3 3 3 4
4 3 3 3 3 4 2 4 4 4 2 2 2 2 2 4 4 4 2 4 3 3 3 3 4
4 3 3 3 3 4 4 4 2 2 2 2 2 2 2 2 2 4 4 4 3 3 3 3 4
4 3 3 3 3 4 4 4 4 4 4 4 4 4 4 4 4 4 4 4 3 3 3 3 4
4 3 3 3 3 3 3 3 3 3 3 3 3 3 3 3 3 3 3 3 3 3 3 3 4
4 4 3 3 3 3 3 3 3 3 3 3 3 3 3 3 3 3 3 3 3 3 3 4 4
4 4 4 3 3 3 3 3 3 3 3 3 3 3 3 3 3 3 3 3 3 3 4 4 4
4 4 4 4 3 3 3 3 3 3 3 3 3 3 3 3 3 3 3 3 3 4 4 4 4
4 4 4 4 4 4 4 4 4 4 4 4 4 4 4 4 4 4 4 4 4 4 4 4 4

[time-record]
00:20:44

[description]
Why ?

[start-position]
2 10
right

[laps]
2

[size]
25 20

