[laps]
2

[size]
50 20

[board]
2 2 2 2 2 2 2 2 2 2 2 2 2 2 2 2 2 2 2 2 2 2 2 2 2 2 2 2 2 2 2 2 2 2 2 2 2 2 2 2 2 2 2 2 2 2 2 2 2 2
2 9 9 9 9 9 9 0 9 9 9 9 9 2 2 2 2 2 2 2 2 2 2 2 2 9 9 9 9 9 9 9 9 9 9 2 2 2 2 9 9 9 9 9 9 9 9 9 9 2
2 9 9 9 9 9 9 0 9 9 9 9 9 9 9 9 9 2 2 2 2 2 2 2 2 9 9 9 9 9 9 9 9 9 9 9 2 2 2 9 9 9 9 9 9 9 9 9 9 2
2 9 9 9 9 9 9 0 9 9 9 9 9 9 9 9 9 9 9 2 2 2 9 9 9 9 9 9 9 9 9 9 9 9 9 9 9 2 2 9 9 9 2 2 2 2 9 9 9 2
2 9 9 9 9 2 2 2 2 2 9 9 9 9 9 9 9 9 9 9 9 9 9 9 9 9 9 9 2 2 2 2 2 9 9 9 9 2 2 9 9 9 2 2 2 2 9 9 9 2
2 9 9 9 2 2 2 2 2 2 2 2 2 9 9 9 9 9 9 9 9 9 9 9 9 9 9 2 2 2 2 2 2 9 9 9 9 2 2 9 9 9 2 2 2 2 9 9 9 2
2 9 9 9 2 2 2 2 2 2 2 2 2 2 2 2 2 9 9 9 9 9 2 2 2 2 2 2 2 2 2 2 2 2 9 9 9 9 9 9 9 9 2 2 2 2 9 9 9 2
2 9 9 9 2 2 2 2 2 2 2 2 2 2 2 2 2 2 2 2 2 2 2 2 2 2 2 2 2 2 2 2 2 2 9 9 9 9 9 9 9 9 2 2 2 2 9 9 9 2
2 9 9 9 2 2 2 2 2 2 2 2 2 2 2 2 2 2 2 2 2 2 2 2 2 2 2 2 2 2 2 2 2 2 2 9 9 9 9 9 2 2 2 2 2 2 9 9 9 2
2 9 9 9 2 2 2 2 2 2 2 2 2 2 2 2 2 2 2 2 2 2 2 2 2 2 2 2 2 2 2 2 2 2 2 2 2 2 2 2 2 2 2 2 2 2 9 9 9 2
2 9 9 9 2 2 2 2 2 2 2 2 2 2 2 2 2 2 2 2 2 2 2 2 9 9 9 9 9 9 9 9 2 2 2 2 2 2 2 2 2 2 2 2 2 2 9 9 9 2
2 9 9 9 2 2 2 2 2 2 2 2 2 2 2 2 2 2 2 2 2 2 2 2 9 9 9 9 9 9 9 9 9 2 2 2 2 2 2 2 2 2 2 2 2 2 9 9 9 2
2 9 9 9 2 2 2 2 2 2 2 2 2 2 2 2 2 2 2 2 2 2 2 9 9 9 9 9 9 9 9 9 9 2 2 2 2 2 2 2 2 2 2 2 2 2 9 9 9 2
2 9 9 9 9 2 2 2 2 2 2 2 2 2 2 2 2 2 2 2 2 2 2 9 9 9 9 2 2 2 9 9 9 9 2 2 2 2 2 2 2 2 2 2 2 9 9 9 9 2
2 9 9 9 9 2 2 2 2 2 2 2 2 2 2 2 2 2 2 2 2 2 2 9 9 9 9 2 2 2 9 9 9 9 9 2 2 2 2 2 2 2 2 2 2 9 9 9 9 2
2 9 9 9 9 9 9 9 2 2 2 2 2 2 2 2 2 2 2 2 2 2 9 9 9 9 9 2 2 2 9 9 9 9 9 9 2 2 2 2 2 2 2 2 9 9 9 9 9 2
2 9 9 9 9 9 9 9 9 9 9 9 9 9 9 9 2 2 2 2 2 2 9 9 9 9 9 2 2 2 9 9 9 9 9 9 9 9 9 9 9 9 9 9 9 9 9 9 9 2
2 9 9 9 9 9 9 9 9 9 9 9 9 9 9 9 9 9 9 9 9 9 9 9 9 9 9 2 2 2 9 9 9 9 9 9 9 9 9 9 9 9 9 9 9 9 9 9 9 2
2 9 9 9 9 9 9 9 9 9 9 9 9 9 9 9 9 9 9 9 9 9 9 9 9 9 9 2 2 2 9 9 9 9 9 9 9 9 9 9 9 9 9 9 9 9 9 9 9 2
2 2 2 2 2 2 2 2 2 2 2 2 2 2 2 2 2 2 2 2 2 2 2 2 2 2 2 2 2 2 2 2 2 2 2 2 2 2 2 2 2 2 2 2 2 2 2 2 2 2

[description]
HELL NO

[start-position]
2 4
right

[start-line]
left
1 7
3 7

