[filename]
circuit3

[lap-record]
01:32:07

[start-line]
down
21 2
21 4

[board]
4 4 4 4 4 4 4 4 4 4 4 4 4 4 4 4 4 4 4 4 4 4 4 4 4 4 4 4 4 4
4 4 4 4 4 4 4 4 4 4 4 4 4 4 4 4 4 4 4 4 4 4 4 4 4 4 4 4 4 4
4 4 3 3 3 3 3 3 3 3 3 3 3 3 3 3 3 3 3 3 3 3 3 4 4 4 3 3 4 4
4 4 3 3 3 3 3 3 3 3 3 3 3 3 3 3 3 3 3 3 3 3 3 3 3 4 4 4 4 4
4 4 3 3 3 4 4 4 4 4 4 4 4 4 4 4 4 4 4 4 4 4 3 3 3 3 3 4 4 4
4 4 3 3 3 4 3 3 3 3 3 3 3 3 3 3 3 3 3 3 3 3 3 3 3 3 3 4 4 4
4 4 3 3 3 4 3 3 3 3 3 3 3 3 3 3 3 3 3 3 3 3 3 3 3 3 3 4 4 4
4 4 3 3 3 4 3 3 3 3 3 3 3 3 3 3 3 3 3 3 3 3 3 3 3 3 3 4 4 4
4 4 3 3 3 4 3 3 3 4 4 4 4 4 4 4 4 4 4 4 4 4 4 4 4 3 4 4 4 4
4 4 3 3 3 4 3 3 3 4 3 3 3 3 3 3 3 3 4 3 3 3 3 3 4 4 4 4 4 4
4 4 3 3 3 4 3 3 3 3 3 3 3 3 3 3 3 3 3 3 3 3 3 3 3 3 3 3 4 4
4 4 3 3 3 4 3 3 3 3 3 3 3 3 4 3 3 3 3 3 3 3 3 3 3 3 3 3 4 4
4 4 3 3 3 4 3 3 3 4 4 4 4 4 4 4 4 4 4 4 4 4 4 3 3 4 3 3 4 4
4 4 3 3 3 4 4 4 4 4 3 3 3 3 3 3 3 3 3 3 3 4 4 3 3 3 3 3 4 4
4 4 3 3 3 4 3 3 4 4 4 3 3 3 3 3 3 3 3 3 3 3 3 3 3 3 3 3 4 4
4 4 3 3 3 4 3 3 3 3 4 4 3 3 3 3 3 3 3 3 3 3 3 3 3 3 3 4 4 4
4 4 3 3 3 4 3 3 3 3 3 4 4 3 3 3 3 3 3 3 3 3 3 3 3 3 4 4 4 4
4 4 3 3 3 4 3 3 3 3 3 3 3 4 4 3 3 3 3 3 3 3 3 3 3 4 4 3 4 4
4 4 3 3 3 4 3 3 3 3 3 3 3 3 3 4 3 3 3 3 3 3 4 4 4 4 3 3 4 4
4 4 3 3 3 4 3 3 3 3 3 3 3 3 3 3 4 3 3 3 3 3 3 3 3 3 3 3 4 4
4 4 3 3 3 4 3 3 3 4 3 3 3 3 3 3 4 4 3 3 3 3 3 3 3 3 3 3 4 4
4 4 0 0 0 4 3 3 3 4 4 3 3 3 3 3 3 4 4 3 3 3 3 3 3 3 3 3 4 4
4 4 3 3 3 4 3 3 3 3 4 3 3 3 3 3 3 3 4 4 3 3 3 3 3 3 3 3 4 4
4 4 3 3 3 4 3 3 3 3 4 3 3 3 3 3 3 3 3 4 4 3 3 3 3 3 3 3 4 4
4 4 3 3 3 4 3 3 3 3 4 4 3 3 3 3 3 3 3 3 4 4 3 3 3 3 3 3 4 4
4 4 3 3 3 4 3 3 3 3 3 4 4 4 3 3 3 3 3 3 3 4 4 3 3 3 3 3 4 4
4 4 3 3 3 4 4 3 3 3 3 3 3 4 4 3 3 3 3 3 3 3 4 4 3 3 3 3 4 4
4 4 3 3 3 4 4 4 3 3 3 3 3 3 4 4 4 3 3 3 3 3 3 4 4 3 3 3 4 4
4 4 3 3 3 4 4 4 4 3 3 3 3 3 3 3 4 4 3 3 3 3 3 3 4 3 3 3 4 4
4 4 3 3 3 4 3 3 4 4 4 3 3 3 3 3 3 4 4 4 3 3 3 3 4 3 3 3 4 4
4 4 3 3 3 4 3 3 3 3 4 4 3 3 3 3 3 3 3 4 3 3 3 3 4 3 3 3 4 4
4 4 3 3 3 4 3 4 4 3 3 4 4 3 3 3 3 3 3 4 3 3 3 3 4 3 3 3 4 4
4 4 3 3 3 4 4 3 3 4 3 3 4 3 3 3 3 3 3 4 3 3 3 3 4 3 3 3 4 4
4 4 3 3 3 3 4 4 3 3 3 4 4 3 3 3 3 3 4 4 3 3 3 3 4 3 3 3 4 4
4 4 4 3 3 3 3 4 4 4 4 4 3 3 3 3 3 4 4 4 3 3 3 3 4 3 3 3 4 4
4 4 4 3 3 3 3 3 3 3 3 3 3 3 3 3 3 4 4 4 4 3 3 3 3 3 3 3 4 4
4 4 4 4 3 3 3 3 3 3 3 3 3 3 3 3 4 4 4 4 4 3 3 3 3 3 3 3 4 4
4 4 4 4 4 4 4 3 3 3 3 3 3 3 3 4 4 4 4 4 4 4 3 3 3 3 3 3 4 4
4 4 4 4 4 4 4 4 4 4 4 4 4 4 4 4 4 4 4 4 4 4 4 4 4 4 4 4 4 4
4 4 4 4 4 4 4 4 4 4 4 4 4 4 4 4 4 4 4 4 4 4 4 4 4 4 4 4 4 4

[time-record]
03:09:98

[description]
nothing

[start-position]
25 3
up

[laps]
2

[size]
30 40

