[title]
The first circuit

[size]
20 20

[board]
2 2 2 2 2 2 2 2 2 2 2 2 2 2 2 2 2 2 2 2
2 2 2 2 2 2 2 2 2 2 2 2 2 2 2 2 2 2 2 2
2 2 1 1 1 1 1 0 1 1 1 1 1 1 1 1 1 1 2 2
2 2 1 1 1 1 1 0 1 1 1 1 1 1 1 1 1 1 2 2
2 2 1 1 1 1 2 2 2 2 2 2 2 2 1 1 1 1 2 2
2 2 1 1 1 2 2 2 2 2 2 2 2 2 2 1 1 1 2 2
2 2 1 1 1 2 2 2 2 2 2 2 2 2 2 2 1 1 2 2
2 2 1 1 1 2 2 2 2 2 2 2 2 2 2 2 1 1 2 2
2 2 1 1 1 2 2 2 2 2 2 2 2 2 2 2 1 1 2 2
2 2 1 1 1 2 2 2 2 2 2 2 2 2 2 2 1 1 2 2
2 2 1 1 1 2 2 2 2 2 2 2 2 2 2 2 1 1 2 2
2 2 1 1 1 2 2 2 2 2 2 2 2 2 2 2 1 1 2 2
2 2 1 1 1 2 2 2 1 1 1 1 2 2 2 2 1 1 2 2
2 2 1 1 1 2 2 1 1 1 1 1 1 2 2 2 1 1 2 2
2 2 1 1 1 2 2 1 1 1 1 1 1 2 2 2 1 1 2 2
2 2 1 1 1 1 1 1 1 1 1 1 1 1 1 1 1 1 2 2
2 2 1 1 1 1 1 1 1 1 2 1 1 1 1 1 1 1 2 2
2 2 2 1 1 1 1 1 1 2 2 1 1 1 1 1 1 1 2 2
2 2 2 2 2 2 2 2 2 2 2 2 2 2 2 2 2 2 2 2
2 2 2 2 2 2 2 2 2 2 2 2 2 2 2 2 2 2 2 2

[start-line]
left
2 7
3 7

[start-position]
3 4
right

[laps]
2

