[filename]
default

[lap-record]
00:05:11

[start-line]
left
26 19
31 20

[board]
4 4 1 1 1 1 1 1 1 1 1 1 1 1 1 1 1 1 1 1 1 1 1 1 1 1 1 1 1 1 1 1 1 1 1 1 1 1 1 1 1
4 1 1 1 1 1 1 1 1 1 1 1 1 1 1 1 1 1 1 1 1 1 1 1 1 1 1 1 1 1 1 1 1 1 1 1 1 1 1 1 1
1 1 1 1 1 1 1 1 1 1 1 1 1 1 1 1 1 1 1 1 1 1 1 1 1 1 1 1 1 1 1 1 1 1 1 1 1 1 1 1 1
1 1 1 1 8 1 1 1 8 1 1 7 7 7 7 7 1 1 6 1 1 1 1 1 1 4 1 1 1 1 1 1 2 2 2 2 2 1 1 1 1
1 1 1 1 8 1 1 1 8 1 1 7 1 1 1 7 1 1 6 1 1 1 1 1 1 4 1 1 1 1 1 1 2 1 1 1 1 1 1 1 1
1 1 1 1 8 1 8 1 8 1 1 7 7 7 7 7 1 1 6 1 1 1 1 1 1 4 1 1 1 1 1 1 2 2 2 2 2 1 1 1 1
1 1 1 1 8 1 8 1 8 1 1 7 1 1 1 7 1 1 6 1 1 1 1 1 1 4 1 1 1 1 1 1 1 1 1 1 2 1 1 1 1
1 1 1 1 8 8 8 8 8 1 1 7 1 1 1 7 1 1 6 6 6 6 6 1 1 4 4 4 4 4 1 1 2 2 2 2 2 1 1 1 1
1 1 1 1 1 1 1 1 1 1 1 1 1 1 1 1 1 1 1 1 1 1 1 1 1 1 1 1 1 1 1 1 1 1 1 1 1 1 1 1 1
1 1 1 8 8 8 8 8 8 8 7 7 7 7 7 7 7 6 6 6 6 6 6 6 4 4 4 4 4 4 4 2 2 2 2 2 2 2 1 1 1
1 1 1 8 8 8 8 8 8 8 7 7 7 7 7 7 7 6 6 6 6 6 6 6 4 4 4 4 4 4 4 2 2 2 2 2 2 2 1 1 1
1 1 1 8 8 8 8 8 8 8 7 7 7 7 7 7 7 6 6 6 6 6 6 6 4 4 4 4 4 4 4 2 2 2 2 2 2 2 1 1 1
1 1 1 8 8 8 8 8 8 8 7 7 7 7 7 7 7 6 6 6 6 6 6 6 4 4 4 4 4 4 4 2 2 2 2 2 2 2 1 1 1
1 1 1 8 8 8 8 8 8 8 7 7 7 7 7 7 7 6 6 6 6 6 6 6 4 4 4 4 4 4 4 2 2 2 2 2 2 2 1 1 1
1 1 1 5 5 5 5 5 5 5 10 10 10 10 10 10 10 1 1 1 1 1 1 1 3 3 3 3 3 3 3 9 9 9 9 9 9 9 1 1 1
1 1 1 5 5 5 5 5 5 5 10 10 10 10 10 10 10 1 1 1 1 1 1 1 3 3 3 3 3 3 3 9 9 9 9 9 9 9 1 1 1
1 1 1 5 5 5 5 5 5 5 10 10 10 10 10 10 10 1 1 1 1 1 1 1 3 3 3 3 3 3 3 9 9 9 9 9 9 9 1 1 1
1 1 1 5 5 5 5 5 5 5 10 10 10 10 10 10 10 1 1 1 1 1 1 1 3 3 3 3 3 3 3 9 9 9 9 9 9 9 1 1 1
1 1 1 5 5 5 5 5 5 5 10 10 10 10 10 10 10 1 1 1 1 1 1 1 3 3 3 3 3 3 3 9 9 9 9 9 9 9 1 1 1
1 1 1 1 1 1 1 1 1 1 1 1 1 1 1 1 1 1 1 1 1 1 1 1 1 1 1 1 1 1 1 1 1 1 1 1 1 1 1 1 1
1 1 1 9 9 9 9 1 5 5 5 5 1 3 3 3 3 1 10 1 1 10 1 9 1 1 9 1 5 5 5 1 1 3 3 3 3 1 1 1 1
1 1 1 9 1 1 1 1 5 1 1 5 1 3 1 1 3 1 10 1 1 10 1 9 9 1 9 1 5 1 1 5 1 3 1 1 1 1 1 1 1
1 1 1 9 1 9 9 1 5 5 5 5 1 3 1 1 3 1 10 1 1 10 1 9 1 9 9 1 5 1 1 5 1 3 3 3 3 1 1 1 1
1 1 1 9 1 1 9 1 5 1 5 1 1 3 1 1 3 1 10 1 1 10 1 9 1 9 9 1 5 1 1 5 1 1 1 1 3 1 1 1 1
1 1 1 9 9 9 9 1 5 1 1 5 1 3 3 3 3 1 10 10 10 10 1 9 1 1 9 1 5 5 5 1 1 3 3 3 3 1 1 1 1
1 1 1 1 1 1 1 1 1 1 1 1 1 1 1 1 1 1 1 1 1 1 1 1 1 1 1 1 1 1 1 1 1 1 1 1 1 1 1 1 1
1 1 1 1 1 1 1 1 1 1 1 1 1 1 1 1 1 1 1 0 0 1 1 1 1 1 1 1 1 1 1 1 1 1 1 1 1 1 1 1 1
1 1 1 1 1 1 1 1 1 1 1 1 1 1 1 1 1 1 1 0 0 1 1 1 1 1 1 1 1 1 1 1 1 1 1 1 1 1 1 1 1
1 1 1 1 1 1 1 1 1 1 1 1 1 1 1 1 1 1 1 0 0 1 1 1 1 1 1 1 1 1 1 1 1 1 1 1 1 1 1 1 1
1 1 1 1 1 1 1 1 1 1 1 1 1 1 1 1 1 1 1 0 0 1 1 1 1 1 1 1 1 1 1 1 1 1 1 1 1 1 1 1 1
1 1 1 1 1 1 1 1 1 1 1 1 1 1 1 1 1 1 1 0 0 1 1 1 1 1 1 1 1 1 1 1 1 1 1 1 1 1 1 1 1
1 1 1 1 1 1 1 1 1 1 1 1 1 1 1 1 1 1 1 0 0 1 1 1 1 1 1 1 1 1 1 1 1 1 1 1 1 1 1 1 1
1 1 1 1 1 1 1 1 1 1 1 1 1 1 1 1 1 1 1 1 1 1 1 1 1 1 1 1 1 1 1 1 1 1 1 1 1 1 1 1 1
1 1 1 1 1 1 1 1 1 1 1 1 1 1 1 1 1 1 1 1 1 1 1 1 1 1 1 1 1 1 1 1 1 1 1 1 1 1 1 1 4
1 1 1 1 1 1 1 1 1 1 1 1 1 1 1 1 1 1 1 1 1 1 1 1 1 1 1 1 1 1 1 1 1 1 1 1 1 1 1 4 4

[time-record]
00:07:78

[description]
explanation

[start-position]
28 18
right

[laps]
1

[size]
41 35

