[filename]
Icy Race

[lap-record]
00:12:02

[start-line]
left
1 10
4 10

[board]
10 10 10 10 10 6 6 6 6 6 6 6 6 6 6 6 10 10 10 10 10
10 10 10 10 6 6 9 9 9 9 0 9 9 9 9 6 6 10 10 10 10
10 10 10 6 6 9 9 9 9 9 0 9 9 9 9 9 6 6 10 10 10
10 10 6 6 9 9 9 9 9 9 0 9 9 9 9 9 9 6 6 10 10
10 6 6 9 9 9 9 9 9 9 0 9 9 9 9 9 9 9 6 6 10
6 6 9 9 9 9 9 6 6 6 6 6 6 6 9 9 9 9 9 6 6
6 9 9 9 9 9 6 6 1 1 1 1 1 6 6 9 9 9 9 9 6
6 9 9 9 9 6 6 1 1 1 1 1 1 1 6 6 9 9 9 9 6
6 9 9 9 9 6 1 1 1 1 1 1 1 1 1 6 9 9 9 9 6
6 9 9 9 9 6 1 1 1 1 1 1 1 1 1 6 9 9 9 9 6
6 9 9 9 9 6 1 1 1 1 1 1 1 1 1 6 9 9 9 9 6
6 9 9 9 9 6 1 1 1 1 1 1 1 1 1 6 9 9 9 9 6
6 9 9 9 9 6 1 1 1 1 1 1 1 1 1 6 9 9 9 9 6
6 9 9 9 9 6 6 1 1 1 1 1 1 1 6 6 9 9 9 9 6
6 9 9 9 9 9 6 6 1 1 1 1 1 6 6 9 9 9 9 9 6
6 6 9 9 9 9 9 6 6 6 6 6 6 6 9 9 9 9 9 6 6
10 6 6 9 9 9 9 9 9 9 9 9 9 9 9 9 9 9 6 6 10
10 10 6 6 9 9 9 9 9 9 9 9 9 9 9 9 9 6 6 10 10
10 10 10 6 6 9 9 9 9 9 9 9 9 9 9 9 6 6 10 10 10
10 10 10 10 6 6 9 9 9 9 9 9 9 9 9 6 6 10 10 10 10
10 10 10 10 10 6 6 6 6 6 6 6 6 6 6 6 10 10 10 10 10

[time-record]
00:02:85

[description]
Snow might be though to master

[start-position]
2 9
right

[laps]
3

[size]
21 21

